wwwwwwwwwwwwwwwwwwwwwwwwwwwwwwww
w          n                  ew
w  wwwwwwwwwwwwwwwwwww  wwwwwwww
w            w        ww       w
w                              w
wwwwwwwwwwww   wwwwwwwwwwwwww  w
w          wwwww               w
w                      n       w
w  wwwwwwwwwwwwwwwwwwwwwwwwwwwww
w                              w
w        n                     w
wwwwwwwwwwwwwwwwwwwwwwwwwwwww  w
w                              w
w     w            n  w        w
w  wwwwwwwwwwwwwwwwwwwwwwwwwwwww
w                              w
w                w           s w
wwwwwwwwwwwwwwwwwwwwwwwwwwwwwwww
