wwwwwwwwwwwwwwwwwwwwwwwwwwwwwwww
w               w              w
w               w     e        w
w +             w   wwwww      w
wwwwwww     wwwww              w
w               w          wwwww
w               w www          w
w       ww                     w
w                              w
w                    www       w
w          www       w w       w
w   w               w          w
w   w                          w
w   w         w  www           w
w   w  www    w                w
w   w         w    wwwww       w
w s w         w              n w
wwwwwwwwwwwwwwwwwwwwwwwwwwwwwwww
