wwwwwwwwwwwwwwwwwwwwwwwwwwwwwwww
w                              w
w                              w
w                              w
w                              w
w                              w
w                              w
w                              w
w                              w
w                              w
w                              w
w                   e          w
w      +     n      www        w
w                        w     w
w                       ww     w
w s       e     w     wwww     w
w  w  t      t www     t       w
wwwwwww wwwwwwwwwwww  wwwwww  ww
